@@@@@@@@@@@@@@@@@@@@
@@@@@@@@@@@@  @@@@@@
@@@@@@@ v@@@o @@@@@@
@@@@@      o  @@@@@@
@@@@  o oo@@ @@@@@@@
@@@  @o@@     @@@@@@
@@@ @ o oo @ @@@@@@@
@@@   o @  @ o @@@@@
@@@@@    @  oo @   @
@@@@@ @@ o         @
@@x    @@@  @@@@@@@@
@@xx xx@@@@@@@@@@@@@
@@xxx@x@@@@@@@@@@@@@
@@xxxxx@@@@@@@@@@@@@
@@@@@@@@@@@@@@@@@@@@
@@@@@@@@@@@@@@@@@@@@
