@@@@@@@@@@@@@@@@@@@@
@@@@@@@@@@@@@@@@@@@@
@@@              @@@
@@@ @ @@@@@@     @@@
@@@ @  o o o o@  @@@
@@@ @   ovo   @@ @@@
@@@ @  o o o@@@xxx@@
@@@ @   o o  @@xxx@@
@@@ @@@ooo o @@xxx@@
@@@     @ @@ @@xxx@@
@@@@@@@   @@ @@xxx@@
@@@@@@@@@@@     @@@@
@@@@@@@@@@@     @@@@
@@@@@@@@@@@@@@@@@@@@
@@@@@@@@@@@@@@@@@@@@
@@@@@@@@@@@@@@@@@@@@
