@@@@@@@@@@@@@@@@@@@@
@@@@@@@@@@@@@@@@@@@@
@@@xxx@@@  @@@@@@@@@
@@@xxx@@@  o  @@@@@@
@@@xxxx@@ o  o@@@@@@
@@@@xxxx@@   o  @@@@
@@@@@xxx @@ o o @@@@
@@@ @@    @  o  @@@@
@@@  @@ @ @@@ @@@@@@
@@@ o @ @o  o    @@@
@@@  o ^ o    o  @@@
@@@   @ o oo o @@@@@
@@@  @@@@@@  @@@@@@@
@@@ @@@@@@@@@@@@@@@@
@@@@@@@@@@@@@@@@@@@@
@@@@@@@@@@@@@@@@@@@@
