@@@@@@@@@@@@@@@@@@@@
@@@@@@@@@@@@@@@@@@@@
@@@@@   @@  @@@@@@@@
@@@@     @  @    @@@
@@  o @o @  @  xxx @
@@ @ o@>o@@ @ @x@x @
@@  @ @o  @    x x @
@@ o    o @ @ @x@x @
@@   @@  @@o o x x @
@@ o @   @  @o@x@x @
@@@ o  o   o  oxxx @
@@@o @@@@@@    @@  @
@@@  @@@@@@@@@@@@@@@
@@@@@@@@@@@@@@@@@@@@
@@@@@@@@@@@@@@@@@@@@
@@@@@@@@@@@@@@@@@@@@
