@@@@@@@@@@@@@@@@@@@@
@@@@@@@@@     @@@@@@
@@@     @ o^o @@@@@@
@@@oo @   @@@@@@@@@@
@@@ @@@xxxxxx@@   @@
@@@   oxxxxxx@@ @ @@
@@@ @@@xxxxxx     @@
@@@   @@@@ @@@ @o@@@
@@  @o   @  o  @ @@@
@@  o ooo  @ o@@ @@@
@@   o o @@@oo @ @@@
@@@@@@     o   @ @@@
@@@@@@@@ @@@   @ @@@
@@@@@@@@     @   @@@
@@@@@@@@@@@@@@@  @@@
@@@@@@@@@@@@@@@@@@@@
