@@@@@@@@@@@@@@@@@@@@
@@@@@@   @  @@@@@@@@
@@@@@@  o   @@@@@@@@
@@@@@@ @o   @@@@@@@@
@@@@  o  @@o   @@@@@
@@@@  @ v o @ o@@@@@
@@@@  @      o @@@@@
@@@@@ @@@@o@@     @@
@@@@ o@xxxxx@ @   @@
@@@@  oxx##x o@ @@@@
@@@@  @xxxxx@   @@@@
@@@   @@@ @@@@@@@@@@
@@@ oo  @  @@@@@@@@@
@@@  @     @@@@@@@@@
@@@@@@@@   @@@@@@@@@
@@@@@@@@@@@@@@@@@@@@
