@@@@@@@@@@@@@@@@@@@@
@@@@   @@@@@@@@@@@@@
@@@@    @@@@@@@@@@@@
@@@@ o  @@@@  @@@@@@
@@@@  oo o   o@@@@@@
@@@@@@> @o    @@@@@@
@@@@@  @@  o o @@@@@
@@@@@ o  @@ @@ x@@@@
@@@@@  @o@@o  @x@@@@
@@@@@@@   oxx@@x@@@@
@@@@@@    @x#xxx@@@@
@@@@@@ oo @xxxxx@@@@
@@@@@@  @@@@@@@@@@@@
@@@@@@  @@@@@@@@@@@@
@@@@@@@@@@@@@@@@@@@@
@@@@@@@@@@@@@@@@@@@@
