@@@@@@@@@@@@@@@@@@@@
@@@@@@@@@@@@@@@@@@@@
@@@@@@xx  @   @@@@@@
@@@@@@xx      @@@@@@
@@@@@@xx  @  @@@@@@@
@@@@@@@@@@@  @  @@@@
@@@@@            @@@
@@@@@  @  @@  @  @@@
@@@@@@ @@  @@@@ @@@@
@@@  o  @@@@@ @  @@@
@@@ @ o  o  @ o  @@@
@@@ >o  o   @   @@@@
@@@@@@ @@ @@@@@@@@@@
@@@@@@    @@@@@@@@@@
@@@@@@@@@@@@@@@@@@@@
@@@@@@@@@@@@@@@@@@@@
