@@@@@@@@@@@@@@@@@@@@
@@@@@@@@@@@@@@@@@@@@
@@@@@@  x  @   @@@@@
@@@@@@ @x    < @@@@@
@@@@@@ @@xx@ @@@@@@@
@@  @ xx@@@     @@@@
@ o @xxx   o @  o @@
@    xx @@  @@ @@ @@
@@@@o@@o@ o @   @ @@
@@@@ @    @o oo @ @@
@@@  o @ @  @ o@@ @@
@@@               @@
@@@  @@@@@@@@@@@  @@
@@@@@@@@@@@@@@@@@@@@
@@@@@@@@@@@@@@@@@@@@
@@@@@@@@@@@@@@@@@@@@
