@@@@@@@@@@@@@@@@@@@@
@@@@@@@@@@@@@@@@@@@@
@@@@@@@@@@@@@@@@@@@@
@@@@@@@@@@@@@@@@@@@@
@@@@xx  @     @@@@@@
@@@@xx  @ o  o  @@@@
@@@@xx  @o@@@@  @@@@
@@@@xx    < @@  @@@@
@@@@xx  @ @  o @@@@@
@@@@@@@@@ @@o o @@@@
@@@@@@ o  o o o @@@@
@@@@@@    @     @@@@
@@@@@@@@@@@@@@@@@@@@
@@@@@@@@@@@@@@@@@@@@
@@@@@@@@@@@@@@@@@@@@
@@@@@@@@@@@@@@@@@@@@
