@@@@@@@@@@@@@@@@@@@@
@@@@@@        @@@@@@
@@     @   o  @> @@@
@@ @@@@@@@o@@@@  @@@
@@ @    @@ @  @o xx@
@@ @ o     @  @  @x@
@@ @ o  @     @o xx@
@@ @  @@@ @@     @x@
@@ @@@  @  @  @o xx@
@@ @    @  @@@@  @x@
@@ @o   o  o  @o xx@
@@    o @ o o @  @x@
@@@@@ o@@@    @o xx@
@@@@@    oo @@@xxxx@
@@@@@      @@@@@@@@@
@@@@@@@@@@@@@@@@@@@@
