@@@@@@@@@@@@@@@@@@@@
@@@@       @@@@@@@@@
@@@@       @@@@@@@@@
@@@@@ @@@@ @  @@@@@@
@@@@@ @v@@    @@@@@@
@@@@ ooo o  oo@@@@@@
@@@@  @ @@ o  @@@@@@
@@@@  @ @@  o @@@@@@
@@@@@@@  ooo o@  @@@
@@@@@   @@   xxxx@@@
@@@@@ @   @ @xx x@@@
@@@@@   @ @ @@xxx@@@
@@@@@@@@@ o  @xxx@@@
@@@@@@@@@@   @@@@@@@
@@@@@@@@@@@@@@@@@@@@
@@@@@@@@@@@@@@@@@@@@
