@@@@@@@@@@@@@@@@@@@@
@    @@@@@@@  @@@@@@
@   o@  @  o  @   @@
@  o  o  o @ o o  @@
@@o o   @ ^@ o    @@
@  o @@@@@@@@@@@ @@@
@ @   @xxxxxxx@ o@@@
@ @@  @ xxxxxx@  @@@
@ @   oxxxxxxxxo @@@
@ @ o @xxxx xx@  @@@
@  o o@@@@o@@@@ o@@@
@ o   @@@ o   o  @@@
@ o     o o  o    @@
@@ @@@@@@ o @@@@@ @@
@         @       @@
@@@@@@@@@@@@@@@@@@@@
