@@@@@@@@@@@@@@@@@@@@
@@@@@@@@@@@@@@@@@@@@
@@@@@@  @  @@@@@@@@@
@@@@@@ o@o @  @@@@@@
@@xx @  @  @   @@@@@
@@xx @ o@o @  o@@@@@
@@x  @     @o  @  @@
@@xx   o@  @ o    @@
@@xx^@  @o @o  @  @@
@@xx @ o@     o@  @@
@@xx @  @oo@o  @  @@
@@xx @ o@  @  o@o  @
@@xx @  @  @   @   @
@@@x @@@@  @@@@@   @
@@@@@@@@@@@@@@@@@@@@
@@@@@@@@@@@@@@@@@@@@
