@@@@@@@@@@@@@@@@@@@@
@xxxxxxxxxx  x@@@@@@
@xxxxxxxxxxoox@  @@@
@@@@@@@@@@@o @   @@@
@      o  o     o @@
@@ @@@@   @  o @  @@
@      @   @@  @ @@@
@  o@  @ @@  @@@ @@@
@ o @o@@@    @@@ @@@
@@@  o @  @  @@@ @@@
@@@    o @@ @  @ @@@
@@ o  @  o  o o   @@
@@  o  o@ooo  @   @@
@@  @  o      @@@@@@
@@ ^@@  @  @  @@@@@@
@@@@@@@@@@@@@@@@@@@@
