@@@@@@@@@@@@@@@@@@@@
@@  @@@@@@@@@@@@@@@@
@@  @   xx@xxxxxx@@@
@@  @ @ @@@@@ xxx@@@
@@@o@    xxxxxxxx@@@
@@   @@o@@@@@@  @@@@
@@ o @     @@@@@@v @
@@@o @ o   @@@@@@  @
@@  o @ooo@@       @
@@      @    @o@o@@@
@@ @@@@ @ooooo    @@
@@ @    o     @   @@
@@ @   @@        @@@
@@ @@@@@@o@@@@@@ o @
@@        @@@@@@   @
@@@@@@@@@@@@@@@@@@@@
