@@@@@@@@@@@@@@@@@@@@
@@@@@@@@@@@@@@@@@@@@
@@@@@@@@@@@@@@@@@@@@
@@@@  @  @@@@@@@@@@@
@@@@  @  @xxx@@@@@@@
@@@  o@  @xxx  @@@@@
@@@ o @oo xxx  @@@@@
@@@  o@  @xxx x@@@@@
@@@   @ o@@@@@@@@@@@
@@@@o       o o @@@@
@@@@  @  oo @   @@@@
@@@@@@@@@  @@oo^@@@@
@@@@@@@@@      @@@@@
@@@@@@@@@@@@@@@@@@@@
@@@@@@@@@@@@@@@@@@@@
@@@@@@@@@@@@@@@@@@@@
