@@@@@@@@@@@@@@@@@@@@
@@@@@@@@@@@@@@@@@@@@
@@xxx   @    @   @@@
@@xxxxx  o@@ @ @o @@
@xxxxxx@  o  @    @@
@xxxxxx@  @  @ @  @@
@@@@@@@@@ o  o o  @@
@@@     @o@@o @@o@@@
@@@   o    @ o    @@
@@  @@ @@@ @  @@o @@
@@ o oo     o  o  @@
@@ o    o@@o @@@@@@@
@@@@@@@@  < @@@@@@@@
@@@@@@@@@@@@@@@@@@@@
@@@@@@@@@@@@@@@@@@@@
@@@@@@@@@@@@@@@@@@@@
