@@@@@@@@@@@@@@@@@@@@
@@@@@@@@@@@   @@@@@@
@@@@@@@ o  o  @@@@@@
@@@@@@ o  o o @@x@@@
@@       oo  @@xx@@@
@@  @@@@@@ @@@xx @@@
@@@ @  @    @xxx @@@
@@ o   @    @xxx @@@
@@^ @o @@ @@@@xxx@@@
@@@@@  o oo  @@xx@@@
@@@@@@  o o  oxxx@@@
@@@@@@ oo  o @  x@@@
@@@@@@   o o  @@@@@@
@@@@@@@@@@@   @@@@@@
@@@@@@@@@@@@@@@@@@@@
@@@@@@@@@@@@@@@@@@@@
