@@@@@@@@@@@@@@@@@@@@
@@@@@@@@@@@@@@@@@@@@
@@   @@@@@@@@@@@@@@@
@@ o  @@@@@@@@@@@@@@
@@@ @ @       @@@@@@
@@@ @   o@o@v  @   @
@@  @      o @   o @
@@  @@@ @@@@@@@@@ @@
@@  @@ xx#xxxxx @ @@
@@@ @@ #x#xx#x# @ @@
@@ o@@@@@@@@@@ @@o @
@@  o   o  o    o  @
@@  @   @   @   @  @
@@@@@@@@@@@@@@@@@@@@
@@@@@@@@@@@@@@@@@@@@
@@@@@@@@@@@@@@@@@@@@
