@@@@@@@@@@@@@@@@@@@@
@@@@@@@@@@@@@@@@@@@@
@@@@@@@@@   @     @@
@@@@@@@@@     o o @@
@@   @@@@@ o@@ @ @@@
@@ o @@   @ @@ o  @@
@@ o  <oo @ @@ooo @@
@@@ @@@   @ @@    @@
@@@ @   @@@ @@@@@o@@
@@@ @     o  @xxxx@@
@@  @@@ @@ o @xxxx@@
@@ o   o @   @xxox @
@@  @@ o @  @@xxxx @
@@@@@@   @@@@@@xxx@@
@@@@@@@@@@@@@@@@@@@@
@@@@@@@@@@@@@@@@@@@@
