@@@@@@@@@@@@@@@@@@@@
@@@@  @@@@@@@@@@@@@@
@@@@  @@  @   @@@@@@
@@@  o@ ovo   @@@@@@
@@@o  o  @ o o@  @@@
@@@  o@@ @o o     @@
@@  @  @ @   ooo  @@
@@ o    o  o@@ @@@@@
@@ o o @o@  @  @@@@@
@@@  @@@  @@@o @@@@@
@@@  @xxxx     @@@@@
@@@@@@xxxxxx@@@@@@@@
@@@@@xxxx@@@@@@@@@@@
@@@@@xxx@@@@@@@@@@@@
@@@@@xxx@@@@@@@@@@@@
@@@@@@@@@@@@@@@@@@@@
