@@@@@@@@@@@@@@@@@@@@
@@@@@@@@@@  @@@@@@@@
@@@@@@     o@@@@@@@@
@@@@@ o  @@ @@@@@@@@
@@@@>o o @ o  @@@@@@
@@@@@@@ @@   o@@@@@@
@@@@@xxxx@o o @@@@@@
@@@@@xxxx@   o@@@@@@
@@@@@xxxx  oo @@@@@@
@@@@@xxx @ o   @@@@@
@@@@@@@@@@o o  @@@@@
@@@@@@@@@@   @@@@@@@
@@@@@@@@@@o @@@@@@@@
@@@@@@@@@@  @@@@@@@@
@@@@@@@@@@@@@@@@@@@@
@@@@@@@@@@@@@@@@@@@@
