@@@@@@@@@@@@@@@@@@@@
@@@@@@     @@  @@@@@
@@@@@@   o   o @@@@@
@@@@@@@@ @@ oo @@@@@
@@@@@   o @    @@@@@
@@@@@ ooo @ @@@@@@@@
@@@@@   @ @ o @@@@@@
@@@@@  @  @  o @@@@@
@@@@@ o@ o@    @@@@@
@@@@@   xx@ @@@@@@@@
@@@@@@@@xx o @v@@@@@
@@@@@xxxxx@ o@ @@@@@
@@@@@@xxxx@  o @@@@@
@@@@@@@xx@@    @@@@@
@@@@@@@@@@@@@@@@@@@@
@@@@@@@@@@@@@@@@@@@@
