@@@@@@@@@@@@@@@@@@@@
@@@@@@@@@@@@@@@@@@@@
@@@@@xxxx   @@@@@@@@
@@@@@x@x@  o @@@@@@@
@@@@@xxxx@ @ <@@@@@@
@@@@ xxxx@  @  @@@@@
@@@@     @o @@o @@@@
@@@@@ @@@  o    @@@@
@@@@@o  o o o@  @@@@
@@@@@ @  o o @@ @@@@
@@@@@  @@@  @@  @@@@
@@@@@    @@ @@ @@@@@
@@@@@  o @  o  @@@@@
@@@@@@@o o   @@@@@@@
@@@@@@@  @@@@@@@@@@@
@@@@@@@@@@@@@@@@@@@@
