@@@@@@@@@@@@@@@@@@@@
@@   @    @ @@@xxxx@
@@   oo@   v  xxxxx@
@@   @ @@@   @ xxxx@
@@@ @@ @@@  @  xxxx@
@@@ o o     @ @ @@@@
@@@  o o@@  @      @
@@@@@ @  @@@@ @ @@ @
@@  @ @o   @@ @    @
@@ o  o  @ @@ @   @@
@@ @ o o    @ @   @@
@@  o @@ @@ @ @@@@@@
@@ oo     oo  @@@@@@
@@@ @@ @@@ o  @@@@@@
@@@    @@@    @@@@@@
@@@@@@@@@@@@@@@@@@@@
