@@@@@@@@@@@@@@@@@@@@
@@@@@@@@@@@@@@   @@@
@@   @@@@  o o o @@@
@@ o   @@ @@ @@  @@@
@@   o o     o  o @@
@@@@ o  @@ @@     @@
@@@@ @@@@@ @@@@@oo @
@@@@o@@@@@ <@@     @
@@@ o  @@@o@@@ o  @@
@@@ o  @   @@@  @@@@
@@@ oo o @   oo @@@@
@@@     @   @@  @@@@
@@@@@@@@@xx x@@@@@@@
@@@@@@xxxxxxxxx@@@@@
@@@@@@xxxxxxxxx@@@@@
@@@@@@@@@@@@@@@@@@@@
