@@@@@@@@@@@@@@@@@@@@
@@@@@@@@@@@@@@@@@@@@
@xxxxxx   @@@@@@@@@@
@xxxxxx   @  @@   @@
@xx@@@ o    o     @@
@xxx o o @   @@   @@
@xxx@o@@@@@    @  @@
@@@    @   @o  @o @@
@@@  oo o o  o@@  @@
@@@  o   @o@o @@o @@
@@@@@ @@ @    @@  @@
@@@@  o o @@ @@@@@@@
@@@@    o  o  @@@@@@
@@@@@   @ @   @@@@@@
@@@@@@@@@^@@@@@@@@@@
@@@@@@@@@@@@@@@@@@@@
