@@@@@@@@@@@@@@@@@@@@
@@@@@@@@@@@@@@@@@@@@
@@@@@@@@@@@@@@@@@@@@
@@@@@@@@@@@ <@@@@@@@
@@@@@     o  @@@@@@@
@@@@@   o@@ o@@@@@@@
@@@@@@o@xxx@ @@@@@@@
@@@@@@ oxxx  @@@@@@@
@@@@@@ @x x@ @@@@@@@
@@@@@@   @ @o @@@@@@
@@@@@@o  o    @@@@@@
@@@@@@  @@@@@@@@@@@@
@@@@@@@@@@@@@@@@@@@@
@@@@@@@@@@@@@@@@@@@@
@@@@@@@@@@@@@@@@@@@@
@@@@@@@@@@@@@@@@@@@@
