@@@@@@@@@@@@@@@@@@@@
@@@@@@@@@@@@@@xxxx@@
@@   @@     @@xxxx@@
@  oo@@  o <@@xxxx@@
@      oo o@  xxxx@@
@  o @@ oo @ @ xxx@@
@  o @@ o  @  xxxx@@
@@ @@@@@ @@@ @@x@@@@
@@   o  o @@   x  @@
@ o@@@  @ @@@@@ @@@@
@   o   @       @@@@
@  o @o o o@@@  @@@@
@ ooo@ o   @@@@@@@@@
@    @  oo @@@@@@@@@
@@@@@@   @@@@@@@@@@@
@@@@@@@@@@@@@@@@@@@@
