@@@@@@@@@@@@@@@@@@@@
@@@@@@          @@@@
@@@@@@  @ @oo o  @@@
@@@@@@o @o@  @@ <@@@
@@@@@@ @@ @ o @ @@@@
@@@@@   o @o  @ @@@@
@@@@@   @ o   @ @@@@
@@@@@@ o o   @@ @@@@
@@@@@  @  @@  o @@@@
@@@@@    @@ oo@ @@@@
@@@@@@@oo   @   @@@@
@@xxxx@  @@@@@@@@@@@
@@x@xxx @@@@@@@@@@@@
@@xxxx   @@@@@@@@@@@
@@xxxx   @@@@@@@@@@@
@@@@@@@@@@@@@@@@@@@@
