@@@@@@@@@@@@@@@@@@@@
@@@@@@@@@@@@   @@@@@
@@@@@@@@@@@     @@@@
@@@@@@@@@@  oo  @@@@
@@@@@@@@@ oo  o @@@@
@@@@@@@@ o    o @@@@
@@@@@@@@   oo @@@@@@
@  @@@@@@@@ @@    @@
@x            ooo^@@
@x@ @@@@@@@ @@   @@@
@x@ @@@@@@@x @o o@@@
@xxxxxxxxxxx @    @@
@@@@@@@@@@@@@@  o @@
@@@@@@@@@@@@@@@  @@@
@@@@@@@@@@@@@@@@@@@@
@@@@@@@@@@@@@@@@@@@@
