@@@@@@@@@@@@@@@@@@@@
@@@@@@@@@@@@@@@@@@@@
@@@@@@@      @@@@@@@
@@@@    @@ o o   <@@
@@@@ @@ @@o@o o o@@@
@@@@ xxxxxx@  oo @@@
@@   xxxxxx@  @   @@
@@ @ xxxxxx@o  o  @@
@@ @oxxxxxx oo@ o @@
@@   @@@ @@@o  o @@@
@@@@  o  o  o  o @@@
@@@@  o  o  o  o @@@
@@@@@@@@@   @@@@@@@@
@@@@@@@@@@@@@@@@@@@@
@@@@@@@@@@@@@@@@@@@@
@@@@@@@@@@@@@@@@@@@@
