@@@@@@@@@@@@@@@@@@@@
@@@@@@@@@@@@@@@@@@@@
@@@@@@@@@@@@@@@@@@@@
@@@@@@@@@  @  @@@@@@
@@@@@   @   o    @@@
@@@@@ @oo @@ @@  @@@
@@      @ @  @@ @@@@
@  @@@ o@o  o  o  @@
@xxx    @ @@  @   @@
@xxx@    > @ @@@ @@@
@xxx@  @@@  o  o  @@
@@@@@@@@@@@   @   @@
@@@@@@@@@@@@@@@@@@@@
@@@@@@@@@@@@@@@@@@@@
@@@@@@@@@@@@@@@@@@@@
@@@@@@@@@@@@@@@@@@@@
