@@@@@@@@@@@@@@@@@@@@
@@   @@@@@@@@@@@@@@@
@@ @ @@@@@@@@@@@@@@@
@@      o<@@@@@@@@@@
@@ o @@o @@@   @@@@@
@@ @@@@ o    o @@@@@
@@ @@@@@ @  @o @@@@@
@@  @@@@ @@o      @@
@  o@  o  @ @@ @@ @@
@         @ @xxx@ @@
@@@@@@  @@@  xxx  @@
@@@@@@@@@@@ @xxx@ @@
@@@@@@@@@@@ @@@ @ @@
@@@@@@@@@@@       @@
@@@@@@@@@@@@@@@@@@@@
@@@@@@@@@@@@@@@@@@@@
