@@@@@@@@@@@@@@@@@@@@
@@@@@@@@@@@@@@@@@@@@
@@@@@@@@@@@@@@@@@@@@
@@@@@@@@@@@  @@@@@@@
@@@  o      o @@@@@@
@@   @@ @@   @@xxx@@
@@ @oo o oo@o@@xxx@@
@@ @   >   @   xxx@@
@@  o@ @@@oo   xxx@@
@@ o  oo  o @@xxxx@@
@@@@o       @@@@@@@@
@@@@  @@@@@@@@@@@@@@
@@@@@@@@@@@@@@@@@@@@
@@@@@@@@@@@@@@@@@@@@
@@@@@@@@@@@@@@@@@@@@
@@@@@@@@@@@@@@@@@@@@
