@@@@@@@@@@@@@@@@@@@@
@@@@@@@@@@  @@@@@@@@
@@@@@@@@@@   @@@@@@@
@@@@@@@@@@ oo @@@@@@
@@@@@@@@@@o  o @@@@@
@@@@@@@@    o   @@@@
@@@@@  @ @@@@@  @@@@
@@@    @ @xxxxo @@@@
@@@ @   o xxxx@ @@@@
@@@  o @ @x#xx@ @@@@
@@@@@  @@@@ @@@ @@@@
@@@@@@@@ >o  @@o@@@@
@@@@@@@@@@ o     @@@
@@@@@@@@@@  @@   @@@
@@@@@@@@@@@@@@@@@@@@
@@@@@@@@@@@@@@@@@@@@
