@@@@@@@@@@@@@@@@@@@@
@@@@@@@@@@@@@@@@@@@@
@@@@@@@@@@   @@@@@@@
@@@@@@@@@@ @o@@  @@@
@@@@@@@@@@     o @@@
@@@@@@@@@@ @@@   @@@
@@xxxx  @@ o  o@@@@@
@@xxxx    o oo @@@@@
@@xxxx  @@o  o <@@@@
@@@@@@@@@@  o  @@@@@
@@@@@@@@@@ o o  @@@@
@@@@@@@@@@@@ @@ @@@@
@@@@@@@@@@@@    @@@@
@@@@@@@@@@@@@@@@@@@@
@@@@@@@@@@@@@@@@@@@@
@@@@@@@@@@@@@@@@@@@@
