@@@@@@@@@@@@@@@@@@@@
@@@@@@@xx    @   @@@
@@@@@@xx# o    o @@@
@@@@@xx#x@ @ @ o@@@@
@@@@xx#x@ @ @ o  @@@
@@@@xxx@  @    @ @@@
@  @@ @          @@@
@ >o o @@@  @   @@@@
@ o   o   @ @   @@@@
@@@oo   @ @ @ @ @@@@
@@@   o   @ @ @@@@@@
@@@ o@ @@@@@      @@
@@@o   @@@@@    @ @@
@@@  @@@@@@@@     @@
@@@  @@@@@@@@    @@@
@@@@@@@@@@@@@@@@@@@@
