@@@@@@@@@@@@@@@@@@@@
@@@@@@@@@@@@@@@@@@@@
@@@@@@@@@@@@@@@@@@@@
@@@@@xx  @@@@v@@@@@@
@@@@@xx  @@@   @@@@@
@@@@@xx     oo @@@@@
@@@@@xx  @ @ o @@@@@
@@@@@xx@@@ @ o @@@@@
@@@@@@@@ o @o  @@@@@
@@@@@@@@  o@ o @@@@@
@@@@@@@@ o  o  @@@@@
@@@@@@@@  @@   @@@@@
@@@@@@@@@@@@@@@@@@@@
@@@@@@@@@@@@@@@@@@@@
@@@@@@@@@@@@@@@@@@@@
@@@@@@@@@@@@@@@@@@@@
